	  NO ./path_to_the_north_texture some other stuff

SO ./path_to_the_south_texture lfkjdhlkjd klj lkj 
    WE     ./path_to_the_west_texture


EA ./path_to_the_east_texture

F 26,32,28 slfkgsfljk

C 51,216,129 

1111111111
  11000001
1110010001
1000000N01
1111111111