	  NO ./path_to_the_north_texture some other stuff

SO ./path_to_the_south_texture lfkjdhlkjd klj lkj 
    WE     ./path_to_the_west_texture


EA ./path_to_the_east_texture

F 26,32,28 slfkgsfljk

C 51,216,129 

11111
10001
10001
1N001
10001
11111