NO ./assets/elmo.png
SO ./assets/elmo.png
WE ./assets/evil.png
EA ./assets/evil.png

F 26,32,28

C 255,0,0 egsefsfsfsefsfs

1111111111
  11000001
1110010N01
1000000001
1111101111
1110001111
  11000001
1110010001
1000000001
1111111111
1111111111
  11000001
1110010001
1000000001
1111101111
1111101111
  11000001
1110010001
1000000001
1111111111
