NO ./assets/mur.png
SO ./assets/mur2.png
WE ./assets/mur3.png
EA ./assets/mur4.png

F 26,32,28 slfkgsfljk

C 51,216,129 

1111111111111111111111111
1000000000110000000000001
1011000001110000000000001
1111000000000000000000001
    1111111110110000011101111
111100000011000001110111111111111
11110111111101011100000010001
  11110111110111011101010010011
11000000110101011100000010001
11000000000000001100000000001
  10000000000000001101010010111
11000001110101011111011110N0111
11110111 1110101 101111010001
11111111 1111111 111111111111














