NO ./assets/mur.png
SO ./assets/mur2.png
WE ./assets/mur3.png
EA ./assets/mur4.png

F 26,32,28 slfkgsfljk

C 51,216,129 

111111111111111111111111111111
  11000001  11000001  11000001
111001000111100100011110010001
1000000N0110000000011000000001
111110111111111011111111101111
111110111111111011111111101111
  11000001  11000001  11000001
111001000111100100011110010001
100000000110000000011000000001
111111111111111111111111111111